1111111111111
11E0C00000001
1110111111101
1P00000C00001
1111111111111