1111111111111
1C01000C000C1
1000011111001
100011E00P001
1111111111111