11111111111111111111111111111111111111111111111111111111111111111
1PE00000000000000000000000000000000000000000000000000000000000001
10000000000000000000000111000000000001111111111000000000000000001
10000000000000000000001110000000000011111111111100000000000000001
10000000000000000000011100000000000111000000011110000000000000001
10000000000000000000111000000000001110000000000111000000000000001
10000000000000000001110000000000011100000000000011100000000000001
10000000000000000011100000000000111000000000000001110000000000001
10000000000000000111000000000001110000000000000000111000000000001
10000000000000001110000000000000000000000000000000111000000000001
10000000000000011100000000000000000000000000000000111000000000001
10000000000000111000000000000000000000000000000000111000000000001
10000000000001110000000000000000000000000000000000111000000000001
10000000000011100000000000000000000000000000000000111000000000001
10000000000111000000000000000000000000000000000000111000000000001
10000000001110000000000000000000000000000000000001110000000000001
10000000011100000000000000000000000000000000000011100000000000001
10000000011111111111111111100000000000000000000111000000000000001
10000000011111111111111111100000000000000000001110000000000000001
10000000000000000000000001100000000000000000011100000000000000001
10000000000000000000000001100000000000000000111000000000000000001
10000000000000000000000001100000000000000001110000000000000000001
10000000000000000000000001100000000000000011100000000000000000001
10000000000000000000000001100000000000000111000000000000000000001
10000000000000000000000001100000000000001110000000000000000C00001
10000000000000000000000001100000000000011100000000000000000000001
10000000000000000000000001100000000000111000000000000000000000001
10000000000000000000000001100000000001111111111111111110000000001
10000000000000000000000001100000000011111111111111111110000000001
10000000000000000000000000000000000000000000100000000000000000001
10000000000000000000000000000000000000000000000000000000000000001
11111111111111111111111111111111111111111111111111111111111111111